registeredEmail = "open.kzn.registered@gmail.com"
registeredEmailPassword = (телефон как в e-mail)

unregisteredEmail = "open.kzn.unregistered@gmail.com"
unregisteredEmailPassword = (телефон как в e-mail)

timestampEmail = (HH.mm.ss_dd-MM-yyyy@lagunov.pro)
Пример timestampEmail: 11.22.34_29-03-2019@lagunov.pro

registeredUserLogin = "open.kzn.registered@gmail.com"
registeredUserPassword = "q6108r"

unregisteredUserLogin = "open.kzn.unregistered@gmail.com"
unregisteredUserPassword = "ABC123"

invalidEmails
invalidEmailsHasPlus = "us+er@mailru"
invalidEmailsNoDot = "user@mailru"
invalidEmailsNoAt = "usermail.ru"
invalidEmailsWithSpace = "us er@mail.ru"
invalidEmailsNoUser = "@mail.ru"
invalidEmailsNoDomain = "user@.ru"

js_nofify
msgRegistrationSuccess = "Вы успешно зарегистрированы! Логин и пароль были высланы Вам на email. Приятной работы в системе."
msgRegistrationEmailDuplicate = "Ошибка! Пользователь с таким email уже существует."
msgRegistrationEmailEmpty = "Заполните корректно поле Email"
msgRegistrationEmailInvalid = "Значение «Email» не является правильным email адресом."

msgRecoverRegisteredEmail = "Восстановление пароля прошло успешно!"
msgRecoverSuccess = "Ваш пароль успешно изменён"

msgProfileDeletionSuccess = "Пользователь удалён"
msgLoginFail = "Неправильные логин и/или пароль"
msgPasswordResetUnregisted = "Данный email не зарегистрирован в системе"

msgOrderInvalidPersonalAccountExplanation = "Ваши действия:
1. Если в списке компаний, указанных на главной странице портала, нет Вашей, то это значит, что руководству Вашей компании необходимо обратиться с заявлением о подключении Вашего дома к системе 'Открытая Казань' в службу поддержки.
2. Если Вы нашли свою компанию в списке компаний подключенных к системе, то это значит, что в ближайшее время данная система для Вас будет доступна, а в настоящее время ведутся технические работы по запуску Вашего дома в систему.
Служба поддержки: support@open.kzn.ru."

msgOrderPersonalAccountInvalid = "Ваш номер лицевого счета не зарегистрирован в базе данных."
msgOrderPersonalAccountEmpty = "Необходимо заполнить «Лицевой счёт»."
msgOrderPersonalAccountNotDigits = "Значение «Лицевой счёт» должно быть целым числом."

msgOrderPersonalPhoneWrongFormat = "Неправильный формат. Номер телефона необходимо вводить в формате 7xxxxxxxxxx, 8xxxxxxxxxx, 2xxxxxx, 5xxxxxx, -;"

msgOrderValueTooLarge = "414 Request-URI Too Large"

modal__header
msgProfileDeletionConfirmation = "Удалить профиль?"


